/-------------------------------------\
|									 &|
|---------\ /------^ ! ^ ! < ! < =   -|
|=========| |                         |
|========+: :+          ,       /     |
|========\_~_/      ' !   !!. !!|     |
|         | |     .             |     |
|        /   \     ! * ___   ___|     |
|   |   /      :            ^|%       |
|+______/______:______!.!.!^_|________|