/------------------------------\
|(     |                  |[__)|
|      |                  |    |
|                         |    |
|---x--!--x--{    /  \   {|    |
|             !!!!!  !!!! |    |
|  =   =  }___!___!___!___|    |
|                         |    |
|               {             ]|
|-+-+-+-+-+!+-+-+!+-+-++!++----|
