    /---------------------------------------|
   /                                        |
  /                                         |
 /                [new map]                 |
/                 [load map]                |
|                 [mods]                    |
|                 [exit]                    |
---------------------------------------------
